### Φαγητό (Еда, 60 слов)

ψωμί — хлеб  
τυρί — сыр  
γάλα — молоко  
νερό — вода  
καφές — кофе  
τσάι — чай  
μήλο — яблоко  
πορτοκάλι — апельсин  
μπανάνα — банан  
σταφύλι — виноград  
σαλάτα — салат  
κρέας — мясо  
κοτόπουλο — курица  
ψάρι — рыба  
αυγό — яйцо  
ρύζι — рис  
ζυμαρικά — макароны / паста  
πατάτα — картофель  
ντομάτα — помидор  
αγγούρι — огурец  
καρότο — морковь  
κρεμμύδι — лук  
σκόρδο — чеснок  
λάδι — масло (обычно оливковое)  
βούτυρο — масло сливочное  
μέλι — мёд  
ζάχαρη — сахар  
αλάτι — соль  
πιπέρι — перец  
σοκολάτα — шоколад  
γλυκό — сладость / десерт  
κέικ — кекс / торт  
μπισκότο — печенье  
παγωτό — мороженое  
γιαούρτι — йогурт  
φρούτο — фрукт  
λαχανικό — овощ  
χυμός — сок  
σούπα — суп  
πιτάκι — пирожок  
πίτσα — пицца  
μπιφτέκι — котлета / бифштекс  
λουκάνικο — колбаса / сосиска  
σαλάμι — салями  
ψωμάκι — булочка  
τοστ — тост  
σάντουιτς — сэндвич  
τυρόπιτα — сырный пирог  
σπαγγέτι — спагетти  
μακαρόνια — макароны  
κεφτέδες — тефтели / фрикадельки  
σαλάτα εποχής — сезонный салат  
καρύδια — грецкие орехи  
φιστίκια — фисташки / арахис  
σταφίδες — изюм  
πατατάκια — чипсы  
πίτα — пирог / пита  
