
### Εργασία και γραφείο
(Работа и офис)

# Εργασία (Работа)
δουλειά – работа
επάγγελμα – профессия
καριέρα – карьера
γραφείο – офис
εταιρεία – компания
υπάλληλος – сотрудник
αφεντικό – начальник
συνάδελφος – коллега
συνάντηση – встреча
τηλέφωνο – телефон
υπολογιστής – компьютер
ηλεκτρονικό ταχυδρομείο – электронная почта
έγγραφο – документ
φάκελος – папка
έντυπο – бланк
σύμβαση – контракт
συμφωνία – соглашение
μισθός – зарплата
χρόνος εργασίας – рабочее время

# Γραφείο (Офис)
καρέκλα – стул
τραπέζι – стол
οθόνη – экран
πληκτρολόγιο – клавиатура
ποντίκι – мышь
εκτυπωτής – принтер
χαρτί – бумага
στυλό – ручка
μολύβι – карандаш
σημειωματάριο – блокнот
πίνακας – доска

# Ρήματα (Глаголы)
δουλεύω – я работаю
γράφω – я пишу
διαβάζω – я читаю
τηλεφωνώ – я звоню
στέλνω – я отправляю
λαμβάνω – я получаю
συνεργάζομαι – я сотрудничаю
οργανώνω – я организую
υπογράφω – я подписываю
συμφωνώ – я соглашаюсь
παρουσιάζω – я презентую
προγραμματίζω – я планирую
κερδίζω – я зарабатываю
