# Καιρός και εποχές (Погода и времена года)

καιρός — погода
ζέστη — жара / тепло
κρύο — холод
ήλιος — солнце
φεγγάρι — луна
αστέρι — звезда
ουρανός — небо
σύννεφο — облако
βροχή — дождь
χιόνι — снег
αέρας — воздух
άνεμος — ветер
καταιγίδα — гроза / буря
ομίχλη — туман
θερμοκρασία — температура
βαθμός — градус
πρόγνωση καιρού — прогноз погоды

άνοιξη — весна
καλοκαίρι — лето
φθινόπωρο — осень
χειμώνας — зима

μέρα — день
νύχτα — ночь
πρωί — утро
μεσημέρι — полдень
απόγευμα — послеобеденное время
βράδυ — вечер

είμαι ζεστός — мне жарко
είμαι κρύος — мне холодно
έχει ήλιο — солнечно
έχει βροχή — дождливо
έχει χιόνι — снежно
φυσάει — дует ветер
βρέχει — идёт дождь
χιονίζει — идёт снег
