# Χόμπι και ελεύθερος χρόνος (Хобби и свободное время)

χόμπι — хобби
ελεύθερος χρόνος — свободное время
παιχνίδι — игра
βόλτα — прогулка
ταξίδι — путешествие
άθλημα — спорт / спортивное занятие
γυμναστήριο — спортзал
κολύμβηση — плавание
τρέξιμο — бег
ποδόσφαιρο — футбол
μπάσκετ — баскетбол
τένις — теннис
χορός — танец
τραγούδι — песня
μουσική — музыка
κιθάρα — гитара
πιάνο — пианино
κινηματογράφος — кинотеатр
θέατρο — театр
βιβλίο — книга
περιοδικό — журнал
εφημερίδα — газета
ζωγραφική — живопись / рисование
φωτογραφία — фотография
μαγείρεμα — готовка
κήπος — сад / садоводство
ψάρεμα — рыбалка
τηλεόραση — телевизор
υπολογιστής — компьютер
ίντερνετ — интернет
καφές με φίλους — кофе с друзьями

# Ρήματα (Глаголы и выражения)
παίζω — играю
διαβάζω — читаю
τραγουδώ — пою
χορεύω — танцую
ζωγραφίζω — рисую
πηγαίνω βόλτα — иду гулять
πηγαίνω διακοπές — еду в отпуск
πηγαίνω σινεμά — иду в кино
πηγαίνω στο θέατρο — иду в театр
βλέπω τηλεόραση — смотрю телевизор
ακούω μουσική — слушаю музыку
κάνω γυμναστική — занимаюсь спортом / делаю зарядку
κολυμπάω — плаваю
τρέχω — бегу
βγάζω φωτογραφίες — фотографирую
μαγειρεύω — готовлю
