# Χαιρετισμοί (Приветствия)

γεια σου — привет (на «ты»)
γεια σας — здравствуйте (на «вы»)
καλημέρα — доброе утро / добрый день
καλησπέρα — добрый вечер
καληνύχτα — спокойной ночи
αντίο — до свидания
τα λέμε — увидимся / до встречи
ευχαριστώ — спасибо
ευχαριστώ πολύ — большое спасибо
παρακαλώ — пожалуйста
παρακαλώ πολύ — большое пожалуйста / очень прошу
συγγνώμη — извини
με συγχωρείτε — извините
κανένα πρόβλημα — нет проблем
τι κάνεις; — как дела? (ты)
τι κάνετε; — как дела? (вы)
πώς είσαι; — как ты?
πώς είστε; — как вы?
είμαι καλά — я в порядке / у меня всё хорошо
είμαι μια χαρά — у меня всё отлично
όχι και τόσο καλά — не очень хорошо
πώς σε λένε; — как тебя зовут?
πώς σας λένε; — как вас зовут?
με λένε... — меня зовут...
χαίρω πολύ — очень приятно
ευχαρίστησή μου — мне приятно / с удовольствием
καλώς ήρθες — добро пожаловать (ты)
καλώς ήρθατε — добро пожаловать (вы)
καλή συνέχεια — хорошего продолжения / удачи дальше
καλό βράδυ — добрый вечер / хорошего вечера
καλή μέρα — хорошего дня
καλό ταξίδι — счастливого пути
καλή όρεξη — приятного аппетита
στην υγειά σου — за твоё здоровье (тост)
στην υγειά σας — за ваше здоровье (тост)
χρόνια πολλά — с днём рождения / с праздником
καλή τύχη — удачи
καλά Χριστούγεννα — счастливого Рождества
καλή χρονιά — с Новым годом
καλό Πάσχα — со Светлой Пасхой
