
### Νοσοκομείο, φαρμακείο και υγεία
(Больница, аптека и здоровье)

# Υγεία (Здоровье)
υγεία – здоровье
σώμα – тело
κεφάλι – голова
μάτι – глаз
αυτί – ухо
μύτη – нос
στόμα – рот
δόντι – зуб
λαιμός – горло
καρδιά – сердце
στομάχι – желудок
χέρι – рука
πόδι – нога
πλάτη – спина

# Συμπτώματα (Симптомы)
πόνος – боль
πονοκέφαλος – головная боль
πυρετός – температура
βήχας – кашель
κρύωμα – простуда
γρίπη – грипп
τραυματισμός – травма
πληγή – рана
ζάλη – головокружение
κούραση – усталость
αδυναμία – слабость

# Νοσοκομείο (Больница)
νοσοκομείο – больница
γιατρός – врач
νοσοκόμα – медсестра
ασθενής – пациент
εξέταση – осмотр
ραντεβού – приём
επείγοντα – скорая помощь / неотложка
χειρουργείο – операционная
θεραπεία – лечение
κλίνη – койка

# Φαρμακείο (Аптека)
φαρμακείο – аптека
φαρμακοποιός – фармацевт
φάρμακο – лекарство
χάπι – таблетка
σιρόπι – сироп
σταγόνες – капли
κρέμα – крем
γάζα – марля
επίδεσμος – бинт
θερμόμετρο – термометр

# Ρήματα (Глаголы)
νιώθω – я чувствую
πονάω – я болею / у меня болит
αισθάνομαι – я ощущаю
πηγαίνω στον γιατρό – я иду к врачу
παίρνω φάρμακο – я принимаю лекарство
ξεκουράζομαι – я отдыхаю
θεραπεύομαι – я лечусь
