# Πόλη και μεταφορές (Город и транспорт)

πόλη — город
χωριό — деревня
δρόμος — дорога / улица
πλατεία — площадь
γειτονιά — район / квартал
πάρκο — парк
κήπος — сад
παραλία — пляж
βουνό — гора

κατάστημα — магазин
εστιατόριο — ресторан
καφετέρια — кафе
ξενοδοχείο — гостиница / отель
τράπεζα — банк
ταχυδρομείο — почта
σχολείο — школа
πανεπιστήμιο — университет
νοσοκομείο — больница
φαρμακείο — аптека
εκκλησία — церковь
μουσείο — музей
θέατρο — театр
σινεμά — кинотеатр
στάδιο — стадион

σταθμός — станция / вокзал
αεροδρόμιο — аэропорт
λιμάνι — порт

λεωφορείο — автобус
τρένο — поезд
μετρό — метро
αυτοκίνητο — автомобиль
ταξί — такси
ποδήλατο — велосипед
μοτοσικλέτα — мотоцикл
πλοίο — корабль
αεροπλάνο — самолёт

εισιτήριο — билет
στάση — остановка
διαδρομή — маршрут

οδηγός — водитель
επιβάτης — пассажир
ταξιδιώτης — путешественник
ταξίδι — путешествие

# Ρήματα (Глаголы)
πηγαίνω — иду / еду
έρχομαι — прихожу / приезжаю
φεύγω — ухожу / уезжаю
φτάνω — прибываю / достигаю
περπατώ — иду пешком / гуляю
περιμένω — жду
μπαίνω — вхожу / сажусь (в транспорт)
βγαίνω — выхожу / выхожу из (транспорта)
οδηγώ — вожу / управляю
ταξιδεύω — путешествую
