# Σπουδές και εργασία (Учёба и работа)

σχολείο — школа
τάξη — класс
μάθημα — урок / предмет
βιβλίο — книга
τετράδιο — тетрадь
στυλό — ручка
μολύβι — карандаш
γόμα — ластик
πίνακας — доска

καθηγητής — преподаватель (муж.)
καθηγήτρια — преподавательница (жен.)
δάσκαλος — учитель
δασκάλα — учительница
μαθητής — ученик
μαθήτρια — ученица
φοιτητής — студент
φοιτήτρια — студентка
πανεπιστήμιο — университет
διάλειμμα — перемена / перерыв

εργασία — работа / задание
διάβασμα — чтение / учёба

μαθαίνω — учусь / узнаю
διαβάζω — читаю / учусь
γράφω — пишу
σημειώνω — отмечаю / делаю заметки
ρωτάω — спрашиваю
απαντώ — отвечаю

δουλειά — работа
γραφείο — офис / контора
εργοστάσιο — завод
κατάστημα — магазин
νοσοκομείο — больница
εταιρεία — компания / фирма
επαγγέλμα — профессия

συνάδελφος — коллега
αφεντικό — начальник / босс
υπάλληλος — сотрудник / служащий
συνάντηση — встреча / собрание
τηλέφωνο — телефон
υπολογιστής — компьютер
έγγραφο — документ
λεπτομέρεια — подробность / деталь
χρήματα — деньги
χρόνος εργασίας — рабочее время

δουλεύω — работаю
κερδίζω — зарабатываю / выигрываю
ξοδεύω — трачу
πουλάω — продаю
αγοράζω — покупаю
βοηθώ — помогаю
οργανώνω — организую
συνεργάζομαι — сотрудничаю
