### Αθλητισμός και δραστήριες διακοπές (Спорт и активный отдых)

# Αθλήματα (Виды спорта)
άθλημα — спорт / вид спорта
ποδόσφαιρο — футбол
μπάσκετ — баскетбол
βόλεϊ — волейбол
τένις — теннис
κολύμβηση — плавание
τρέξιμο — бег
ποδηλασία — езда на велосипеде
σκι — лыжи / катание на лыжах
πατινάζ — катание на коньках
γυμναστική — гимнастика / физкультура
γιόγκα — йога
πάλη — борьба
άρση βαρών — тяжёлая атлетика
καράτε — каратэ
χορός — танец

# Εξοπλισμός (Инвентарь)
μπάλα — мяч
ρακέτα — ракетка
δίχτυ — сетка
παπούτσια — обувь / кроссовки
φόρμα — спортивный костюм
γάντια — перчатки
κράνος — шлем
ποδήλατο — велосипед
σανίδα σκι — лыжная доска
πατίνια — ролики / коньки

# Δραστηριότητες (Занятия)
παίζω ποδόσφαιρο — играю в футбол
παίζω μπάσκετ — играю в баскетбол
τρέχω — бегаю
κολυμπάω — плаваю
κάνω γυμναστική — занимаюсь гимнастикой / делаю зарядку
κάνω ποδήλατο — катаюсь на велосипеде
πηγαίνω για περπάτημα — иду на прогулку / гуляю
χορεύω — танцую
κάνω σκι — катаюсь на лыжах
κάνω πατινάζ — катаюсь на коньках

# Εκφράσεις (Фразы)
μου αρέσει ο αθλητισμός — мне нравится спорт
παίζω σε ομάδα — играю в команде
κερδίζω — выигрываю
χάνω — проигрываю / теряю
