
### Αυτοκίνητα, συνεργείο, ατυχήματα, αστυνομία
(Машины, автосервис, аварии, полиция)

# Αυτοκίνητο (Машина)
αυτοκίνητο – машина
όχημα – транспортное средство
τροχός – колесо
λάστιχο – шина
κινητήρας – двигатель
καύσιμα – топливо
βενζίνη – бензин
ντίζελ – дизель
καπό – капот
φρένο – тормоз
τιμόνι – руль
φλας – поворотник
φανάρι – фара
καθρέφτης – зеркало
καθίσμα – сиденье
ζώνη ασφαλείας – ремень безопасности
πορτμπαγκάζ – багажник
παρμπρίζ – лобовое стекло
καθαριστήρας – дворник

# Συνεργείο (Автосервис)
συνεργείο – автосервис
μηχανικός – механик
επισκευή – ремонт
λάδι – масло
έλεγχος – проверка
σέρβις – техобслуживание
αλλαγή λαδιών – замена масла
λάστιχο ρεζέρβα – запасное колесо
μπαταρία – аккумулятор

# Ατύχημα (Авария)
ατύχημα – авария
σύγκρουση – столкновение
ζημιά – повреждение
τραυματισμός – травма
οδήγηση – вождение
παραβίαση – нарушение
ασφάλεια – страховка
ασθενοφόρο – скорая помощь
επείγον – экстренный случай

# Αστυνομία (Полиция)
αστυνομία – полиция
αστυνομικός – полицейский
τροχαία – дорожная полиция
κλήση – штраф
νόμος – закон
κανόνας – правило
άδεια οδήγησης – водительское удостоверение
άδεια κυκλοφορίας – техпаспорт
διαβατήριο – паспорт
έλεγχος – проверка
σταματώ – я останавливаюсь
οδηγώ – я вожу
παραβιάζω – я нарушаю
