### Φύση, δέντρα, ψάρια, ζώα (Природа, деревья, рыбы, животные)

# Φύση (Природа)
φύση — природа
ουρανός — небо
ήλιος — солнце
φεγγάρι — луна
αστέρι — звезда
σύννεφο — облако
βροχή — дождь
χιόνι — снег
αέρας — воздух
άνεμος — ветер
ποτάμι — река
λίμνη — озеро
θάλασσα — море
βουνό — гора
λόφος — холм
δάσος — лес
δέντρο — дерево
θάμνος — куст / кустарник
λουλούδι — цветок
φύλλο — лист
γρασίδι — трава
γη — земля / почва
χώμα — почва / грунт
άμμος — песок
παραλία — пляж
ουράνιο τόξο — радуга

# Δέντρα (Деревья)
πεύκο — сосна
ελιά — олива
δρυς — дуб
πλάτανος — платан
μηλιά — яблоня
αχλαδιά — груша (дерево)
κερασιά — вишня (дерево)
πορτοκαλιά — апельсиновое дерево
λεμονιά — лимонное дерево
φοίνικας — пальма

# Ζώα (Животные)
ζώο — животное
σκύλος — собака
γάτα — кошка
πουλί — птица
κότα — курица
παπάκι — утёнок
άλογο — лошадь
αγελάδα — корова
πρόβατο — овца
κατσίκα — коза
γουρούνι — свинья
λιοντάρι — лев
τίγρη — тигр
αρκούδα — медведь
ελέφαντας — слон
πίθηκος — обезьяна
ζέβρα — зебра
καμηλοπάρδαλη — жираф

# Ψάρια και θαλάσσια ζώα (Рыбы и морские животные)
ψάρι — рыба
δελφίνι — дельфин
φάλαινα — кит
καρχαρίας — акула
χελώνα — черепаха
χταπόδι — осьминог
καβούρι — краб
αστερίας — морская звезда

# Ρήματα (Глаголы)
ζω — живу
κολυμπάω — плаваю
πετάω — лечу / летаю
τρέχω — бегу
πηδάω — прыгаю
τρώω — ем
πίνω — пью
κοιμάμαι — сплю
