# Χρόνος, ημερομηνίες και γιορτές (Время, даты и праздники)

ώρα — час / время
λεπτό — минута
δευτερόλεπτο — секунда
μέρα — день
εβδομάδα — неделя
μήνας — месяц
έτος — год
ημερολόγιο — календарь

σήμερα — сегодня
αύριο — завтра
χθες — вчера

πρωί — утро
μεσημέρι — полдень
απόγευμα — послеобеденное время
βράδυ — вечер
νύχτα — ночь

Δευτέρα — понедельник
Τρίτη — вторник
Τετάρτη — среда
Πέμπτη — четверг
Παρασκευή — пятница
Σάββατο — суббота
Κυριακή — воскресенье

Ιανουάριος — январь
Φεβρουάριος — февраль
Μάρτιος — март
Απρίλιος — апрель
Μάιος — май
Ιούνιος — июнь
Ιούλιος — июль
Αύγουστος — август
Σεπτέμβριος — сентябрь
Οκτώβριος — октябрь
Νοέμβριος — ноябрь
Δεκέμβριος — декабрь

ώρα έναρξης — время начала
ώρα λήξης — время окончания
συμβαίνει — происходит / случается
περιμένω — жду

γιορτή — праздник / именины
γενέθλια — день рождения
Χριστούγεννα — Рождество
Πάσχα — Пасха
Πρωτοχρονιά — Новый год
καλοκαίρι — лето
χειμώνας — зима
αργία — выходной день / праздничный день
διακοπές — отпуск / каникулы

χρόνια πολλά — с днём рождения / с праздником
καλή χρονιά — с Новым годом
καλό Πάσχα — со Светлой Пасхой
καλά Χριστούγεννα — счастливого Рождества
