# Υγεία και σώμα (Здоровье и тело)

υγεία — здоровье
σώμα — тело
κεφάλι — голова
πρόσωπο — лицо
μάτι — глаз
αυτί — ухо
μύτη — нос
στόμα — рот
δόντι — зуб
γλώσσα — язык
λαιμός — горло / шея
χέρι — рука
δάχτυλο — палец
νύχι — ноготь
πόδι — нога
γόνατο — колено
ώμος — плечо
πλάτη — спина
καρδιά — сердце
στομάχι — желудок

γιατρός — врач
νοσοκόμα — медсестра
νοσοκομείο — больница
φαρμακείο — аптека
φάρμακο — лекарство
θεραπεία — лечение
εξέταση — обследование / анализ
ραντεβού — приём / встреча

πόνος — боль
πυρετός — температура / жар
βήχας — кашель
κρύωμα — простуда
γρίπη — грипп
πληγή — рана
ατύχημα — несчастный случай

είμαι άρρωστος — я болен
είμαι καλά — я здоров / у меня всё хорошо
πονάω — у меня болит
αισθάνομαι — я чувствую себя
κουράζομαι — устаю
ξεκουράζομαι — отдыхаю
πηγαίνω στον γιατρό — иду к врачу
παίρνω φάρμακο — принимаю лекарство
