### Γνωριμία και φλερτ (Знакомство и флирт)

# Χαιρετισμοί (Приветствия)
γεια σου — привет (на «ты»)
γεια σας — здравствуйте (на «вы»)
χαίρω πολύ — очень приятно
πώς σε λένε; — как тебя зовут?
με λένε ... — меня зовут ...
από πού είσαι; — откуда ты?
είμαι από ... — я из ...
τι κάνεις; — как дела?
είμαι καλά — у меня всё хорошо

# Σχέσεις και άτομα (Отношения и люди)
αγόρι — мальчик / парень
κορίτσι — девочка / девушка
φίλος — друг (муж.)
φίλη — подруга (жен.)
όμορφος — красивый (муж.)
όμορφη — красивая (жен.)
γλυκός — милый / сладкий (муж.)
γλυκιά — милая / сладкая (жен.)
ωραίος — симпатичный / красивый (муж.)
ωραία — симпатичная / красивая (жен.)
καλός — хороший (муж.)
καλή — хорошая (жен.)

# Συναισθήματα και κομπλιμέντα (Эмоции и комплименты)
μου αρέσεις — ты мне нравишься
σε συμπαθώ — ты мне симпатичен / симпатична
σε αγαπώ — я тебя люблю
σε θέλω — я тебя хочу
χαμογελάω — я улыбаюсь
γελάω — я смеюсь
φιλάω — я целую
αγκαλιάζω — я обнимаю

# Προσκλήσεις (Приглашения)
πάμε για καφέ; — пойдём на кофе?
πάμε μια βόλτα; — пойдём прогуляемся?
θες να βγούμε; — хочешь встретиться?
σε περιμένω — я тебя жду
περνάω καλά — мне хорошо / я хорошо провожу время

# Ρήματα (Глаголы)
γνωρίζω — знакомлюсь / знаю
συναντώ — встречаю
μιλάω — говорю / разговариваю
ακούω — слушаю / слышу
κοιτάζω — смотрю
χαμογελάω — улыбаюсь
φλερτάρω — флиртую
χορεύω — танцую
πίνω — пью
καλώ — приглашаю / зову
