
### Διαδικτυακά μαθήματα, εκπαίδευση και ψηφιακές τεχνολογίες
(Онлайн-курсы, обучение и цифровые технологии)

# Εκπαίδευση (Образование)
εκπαίδευση – образование
μάθηση – обучение
μάθημα – урок
διάλεξη – лекция
σεμινάριο – семинар
μάθημα εξ αποστάσεως – дистанционный урок
καθηγητής – преподаватель
μαθητής – ученик
φοιτητής – студент
ασκηση – упражнение
τεστ – тест
πτυχίο – диплом
πιστοποιητικό – сертификат
γνώση – знание
δεξιότητα – навык

# Διαδίκτυο και τεχνολογία (Интернет и технологии)
διαδίκτυο – интернет
ιστοσελίδα – веб-страница
πλατφόρμα – платформа
εφαρμογή – приложение
πρόγραμμα – программа
υπολογιστής – компьютер
φορητός υπολογιστής – ноутбук
τηλέφωνο – телефон
tablet – планшет
οθόνη – экран
πληκτρολόγιο – клавиатура
ποντίκι – мышь
βίντεο – видео
κάμερα – камера
μικρόφωνο – микрофон

# Ρήματα (Глаголы)
μαθαίνω – я учусь
διαβάζω – я читаю
γράφω – я пишу
παρακολουθώ – я посещаю / смотрю
συμμετέχω – я участвую
επικοινωνώ – я общаюсь
χρησιμοποιώ – я использую
αναζητώ – я ищу
κατεβάζω – я скачиваю
ανεβάζω – я загружаю
συνδέομαι – я подключаюсь / вхожу
αποθηκεύω – я сохраняю
στέλνω – я отправляю
λαμβάνω – я получаю
