# Φαγητό και ποτά (Еда и напитки)

φαγητό — еда
ποτό — напиток
νερό — вода
χυμός — сок
γάλα — молоко
καφές — кофе
τσάι — чай
κρασί — вино
μπύρα — пиво

ψωμί — хлеб
τυρί — сыр
βούτυρο — масло
λάδι — оливковое масло
αλάτι — соль
ζάχαρη — сахар
αλεύρι — мука
αυγό — яйцо
κρέας — мясо
κοτόπουλο — курица
ψάρι — рыба
λαχανικά — овощи
φρούτα — фрукты
πατάτα — картофель
ντομάτα — помидор
αγγούρι — огурец
καρότο — морковь
κρεμμύδι — лук
σκόρδο — чеснок

σαλάτα — салат
σούπα — суп
ρύζι — рис
μακαρόνια — макароны
πίτσα — пицца
σάντουιτς — сэндвич
γλυκό — сладость / десерт
τούρτα — торт
παγωτό — мороженое
σοκολάτα — шоколад
μπισκότο — печенье
μέλι — мёд
ξηροί καρποί — орехи

εστιατόριο — ресторан
καφετέρια — кафе
μπαρ — бар
μαγειρεύω — готовлю
τρώω — ем
πίνω — пью
παραγγέλνω — заказываю
πληρώνω — плачу
