### Τράπεζα και οικονομικά (Банк и финансы)

# Τράπεζα (Банк)
τράπεζα — банк
υποκατάστημα — филиал
ταμείο — касса
ταμίας — кассир
λογαριασμός — счёт
τραπεζικός λογαριασμός — банковский счёт
κατάθεση — вклад / депозит
ανάληψη — снятие (денег)
μεταφορά — перевод
δάνειο — заём / кредит
υποθήκη — ипотека
επιτόκιο — процентная ставка
πιστωτική κάρτα — кредитная карта
χρεωστική κάρτα — дебетовая карта
μετρητά — наличные
νόμισμα — валюта / монета
χαρτονόμισμα — банкнота
κέρμα — монета
PIN — пин-код
ATM — банкомат
ηλεκτρονική τραπεζική — интернет-банкинг

# Οικονομικά (Финансы)
οικονομία — экономика
εισόδημα — доход
έξοδα — расходы
έσοδα — поступления / выручка
κεφάλαιο — капитал
επένδυση — инвестиция
κέρδος — прибыль
ζημιά — убыток / ущерб
φορολογία — налогообложение
φορολογική δήλωση — налоговая декларация
μισθός — зарплата
συμβόλαιο — контракт / договор
συμφωνία — соглашение

# Ρήματα (Глаголы)
πληρώνω — плачу
λαμβάνω — получаю
καταθέτω — вношу / кладу на счёт
σηκώνω (χρήματα) — снимаю (деньги)
μεταφέρω — перевожу
υπολογίζω — подсчитываю / рассчитываю
επενδύω — инвестирую
αποταμιεύω — коплю / откладываю
ξοδεύω — трачу
κερδίζω — зарабатываю / выигрываю
χάνω — теряю / проигрываю
δανείζω — одалживаю (кому-то)
δανείζομαι — беру в долг / занимаю
