# Σπίτι (Дом)

σπίτι — дом
διαμέρισμα — квартира
δωμάτιο — комната
σαλόνι — гостиная
κουζίνα — кухня
υπνοδωμάτιο — спальня
μπάνιο — ванная
τουαλέτα — туалет
διάδρομος — коридор
μπαλκόνι — балкон
κήπος — сад

πόρτα — дверь
παράθυρο — окно
τοίχος — стена
πάτωμα — пол
ταβάνι — потолок
σκάλα — лестница
ασανσέρ — лифт

έπιπλα — мебель
καρέκλα — стул
τραπέζι — стол
καναπές — диван
πολυθρόνα — кресло
κρεβάτι — кровать
ντουλάπα — шкаф
ράφι — полка
βιβλιοθήκη — книжный шкаф / библиотека
καθρέφτης — зеркало
χαλί — ковёр
λάμπα — лампа
φως — свет
κουρτίνα — занавеска / штора
κουβέρτα — одеяло
μαξιλάρι — подушка

ηλεκτρική συσκευή — электрический прибор
τηλεόραση — телевизор
ψυγείο — холодильник
πλυντήριο — стиральная машина
φούρνος — духовка / печь
υπολογιστής — компьютер

# Ρήματα (Глаголы)
καθαρίζω — убираю
μαγειρεύω — готовлю
πλένω — мою / стираю
σκουπίζω — подметаю / пылесошу
τακτοποιώ — привожу в порядок
μένω — живу / проживаю
ανοίγω — открываю
κλείνω — закрываю
