# Βασικά ρήματα (Основные глаголы)

είμαι — быть / я есть
έχω — иметь / у меня есть
κάνω — делать
πηγαίνω — иду / еду
έρχομαι — прихожу / приезжаю
μένω — живу / остаюсь
ζω — живу

βλέπω — вижу
κοιτάζω — смотрю
ακούω — слышу / слушаю
λέω — говорю / скажу
μιλάω — говорю / разговариваю

διαβάζω — читаю / учусь
γράφω — пишу
μαθαίνω — учусь / узнаю
διδάσκω — преподаю / обучаю

δουλεύω — работаю
παίζω — играю
περπατώ — иду пешком / гуляю
τρέχω — бегу

κάθομαι — сижу / остаюсь
σηκώνομαι — встаю / поднимаюсь
στέκομαι — стою
ξυπνάω — просыпаюсь
κοιμάμαι — сплю

τρώω — ем
πίνω — пью
μαγειρεύω — готовлю
καθαρίζω — убираю / чищу
πλένω — мою / стираю

αγοράζω — покупаю
πουλάω — продаю
δίνω — даю
παίρνω — беру

ανοίγω — открываю
κλείνω — закрываю
βοηθώ — помогаю

σκέφτομαι — думаю
θυμάμαι — помню
ξεχνάω — забываю
πιστεύω — верю
καταλαβαίνω — понимаю

ρωτώ — спрашиваю
απαντώ — отвечаю
περιμένω — жду
ακολουθώ — следую

φεύγω — ухожу / уезжаю
φτάνω — прибываю / достигаю
μπαίνω — вхожу
βγαίνω — выхожу

οδηγώ — вожу / управляю
ταξιδεύω — путешествую

φορώ — ношу / надеваю
δοκιμάζω — пробую / примеряю

χαμογελάω — улыбаюсь
κλαίω — плачу
γελάω — смеюсь

παίζω μουσική — играю музыку
τραγουδώ — пою
χορεύω — танцую
