# Επίθετα και επιρρήματα (Прилагательные и наречия)

μεγάλος — большой
μικρός — маленький
ψηλός — высокий
κοντός — низкий / короткий
παχύς — толстый
αδύνατος — худой / слабый
νέος — молодой / новый
γέρος — старый (о человеке)
ωραίος — красивый / хороший
άσχημος — некрасивый / уродливый
καλός — хороший / добрый
κακός — плохой / злой
εύκολος — лёгкий (простой)
δύσκολος — трудный / сложный
φθηνός — дешёвый
ακριβός — дорогой
καυτός — горячий / очень тёплый
κρύος — холодный
ζεστός — тёплый
δροσερός — прохладный

καθαρός — чистый
βρώμικος — грязный
ήσυχος — тихий / спокойный
θορυβώδης — шумный

γρήγορος — быстрый
αργός — медленный

ευτυχισμένος — счастливый
λυπημένος — грустный
κουρασμένος — уставший
χαρούμενος — радостный
υγιής — здоровый
άρρωστος — больной

# Επιρρήματα (Наречия)

πάντα — всегда
συχνά — часто
μερικές φορές — иногда
σπάνια — редко
ποτέ — никогда

τώρα — сейчас
μετά — потом / позже
πριν — раньше

εδώ — здесь
εκεί — там
πάνω — наверху / сверху
κάτω — внизу / снизу
μπροστά — впереди
πίσω — сзади
δίπλα — рядом
κοντά — близко
μακριά — далеко

πολύ — много / очень
λίγο — немного
αρκετά — достаточно

καλά — хорошо
καλύτερα — лучше
χειρότερα — хуже
