### Σχέσεις και συναισθήματα (Отношения и чувства)

# Σχέσεις (Отношения)
σχέση — отношения
φιλία — дружба
αγάπη — любовь
γάμος — брак
αρραβώνας — помолвка
χωρισμός — расставание / развод
οικογένεια — семья
αγόρι — мальчик / парень
κορίτσι — девочка / девушка
σύζυγος — супруг / муж
σύζυγος (жена) — супруга / жена
παιδί — ребёнок

# Συναισθήματα (Эмоции)
χαρά — радость
λύπη — печаль / грусть
θυμός — злость / гнев
φόβος — страх
έρωτας — влюблённость / страсть
ενθουσιασμός — воодушевление / энтузиазм
ζήλια — зависть / ревность
τρυφερότητα — нежность
πάθος — страсть
εμπιστοσύνη — доверие
στοργή — забота / ласка
ελπίδα — надежда
όνειρο — мечта / сон

# Ρήματα (Глаголы)
αγαπώ — люблю
μου αρέσεις — ты мне нравишься
σε θέλω — я тебя хочу
σε σκέφτομαι — я думаю о тебе
ονειρεύομαι — мечтаю / вижу сны
πιστεύω — верю
εμπιστεύομαι — доверяю
νιώθω — чувствую
φοβάμαι — боюсь
ζηλεύω — завидую / ревную
χαμογελάω — улыбаюсь
αγκαλιάζω — обнимаю
φιλάω — целую
φροντίζω — забочусь
στηρίζω — поддерживаю

# Εκφράσεις (Выражения)
σ’ αγαπώ — я тебя люблю
μου λείπεις — я скучаю по тебе
σε σκέφτομαι συνέχεια — я всё время думаю о тебе
θέλω να είμαι μαζί σου — я хочу быть с тобой
είσαι το άλλο μου μισό — ты моя вторая половинка
