### Φρούτα, λαχανικά και χρώματα (Фрукты, овощи и цвета)

# Φρούτα (Фрукты)
μήλο — яблоко
πορτοκάλι — апельсин
μπανάνα — банан
αχλάδι — груша
ροδάκινο — персик
κεράσι — вишня
σταφύλι — виноград
καρπούζι — арбуз
πεπόνι — дыня
φράουλα — клубника
λεμόνι — лимон
μανταρίνι — мандарин
σύκο — инжир
δάμασκηνο — слива
ακτινίδιο — киви
ανανάς — ананас

# Λαχανικά (Овощи)
ντομάτα — помидор
αγγούρι — огурец
καρότο — морковь
πατάτα — картофель
κρεμμύδι — лук
σκόρδο — чеснок
μαρούλι — салат / латук
λάχανο — капуста
μπρόκολο — брокколи
κουνουπίδι — цветная капуста
πιπεριά — перец
μελιτζάνα — баклажан
κολοκύθι — кабачок
σπανάκι — шпинат
αρακάς — горох
φασόλι — фасоль

# Χρώματα (Цвета)
άσπρο — белый
μαύρο — чёрный
κόκκινο — красный
μπλε — синий
πράσινο — зелёный
κίτρινο — жёлтый
πορτοκαλί — оранжевый
καφέ — коричневый
μοβ — фиолетовый
ροζ — розовый
γκρι — серый
χρυσό — золотой
ασημί — серебряный
