### Φαγητό στο εστιατόριο και προϊόντα (Еда в ресторане и продуктах)

# Στο εστιατόριο (В ресторане)
εστιατόριο — ресторан
καφετέρια — кафе / кафетерий
ταβέρνα — таверна
μπαρ — бар
μενού — меню
κατάλογος — каталог / меню
παραγγέλνω — заказываю
παραγγελία — заказ
σερβιτόρος — официант
σερβιτόρα — официантка
λογαριασμός — счёт
τραπέζι — стол
καρέκλα — стул
μαχαιροπίρουνα — столовые приборы
πιρούνι — вилка
μαχαίρι — нож
κουτάλι — ложка
ποτήρι — стакан / бокал
πιάτο — тарелка
πετσέτα — салфетка

# Φαγητά (Блюда)
σαλάτα — салат
σούπα — суп
ψάρι — рыба
κοτόπουλο — курица
μοσχάρι — говядина
χοιρινό — свинина
πατάτες τηγανητές — картофель фри
ρύζι — рис
μακαρόνια — макароны
πίτσα — пицца
σάντουιτς — сэндвич
τυρί — сыр
ψωμί — хлеб
ελιά — оливка
λάδι — масло (обычно оливковое)
γιαούρτι — йогурт

# Γλυκά (Сладости)
γλυκό — сладость / десерт
τούρτα — торт
παγωτό — мороженое
μπισκότο — печенье
σοκολάτα — шоколад
μέλι — мёд

# Ποτά (Напитки)
νερό — вода
χυμός — сок
καφές — кофе
τσάι — чай
κρασί — вино
μπύρα — пиво
αναψυκτικό — прохладительный напиток / газировка

# Εκφράσεις (Фразы)
καλή όρεξη — приятного аппетита
στην υγειά σας — за ваше здоровье (тост)
μου αρέσει — мне нравится
δε μ’ αρέσει — мне не нравится
είναι νόστιμο — это вкусно
