# Οικογένεια και φίλοι (Семья и друзья)

οικογένεια — семья
γονείς — родители
πατέρας — отец
μητέρα — мать
παππούς — дедушка
γιαγιά — бабушка
παιδί — ребёнок
γιος — сын
κόρη — дочь
αδελφός — брат
αδελφή — сестра
θείος — дядя
θεία — тётя
ξάδερφος — двоюродный брат
ξαδέρφη — двоюродная сестра
ανιψιός — племянник
ανιψιά — племянница
σύζυγος — супруг / муж
σύζυγος (жена) — супруга / жена

φίλος — друг (муж.)
φίλη — подруга (жен.)
παρέα — компания / группа друзей
γνωστός — знакомый (муж.)
γνωστή — знакомая (жен.)

γάμος — свадьба / брак
βάφτιση — крещение
γενέθλια — день рождения
γιορτή — праздник / именины

# Ρήματα (Глаголы)
αγαπώ — люблю
παντρεύομαι — женюсь / выхожу замуж
βαφτίζω — крестить
γιορτάζω — праздную
καλώ — приглашаю
συγχαίρω — поздравляю
ευχαριστώ — благодарю
