### Επενδύσεις και ακίνητα (Инвестиции и недвижимость)

# Ακίνητα (Недвижимость)
ακίνητο — недвижимость / объект
σπίτι — дом
διαμέρισμα — квартира
οικόπεδο — земельный участок
κτίριο — здание
γραφείο — офис
κατάστημα — магазин
αποθήκη — склад
βεράντα — веранда / терраса
κήπος — сад
θέα — вид
όροφος — этаж
δωμάτιο — комната
σαλόνι — гостиная
κουζίνα — кухня
υπνοδωμάτιο — спальня
μπάνιο — ванная
τουαλέτα — туалет
γκαράζ — гараж
πάρκινγκ — парковка

# Συναλλαγές (Сделки)
αγορά — покупка
πώληση — продажа
ενοικίαση — аренда
συμβόλαιο — контракт / договор
συμφωνία — соглашение
πληρωμή — оплата
προκαταβολή — аванс / предоплата
υπογραφή — подпись
ιδιοκτησία — собственность
τίτλος ιδιοκτησίας — свидетельство о собственности
δάνειο — кредит / заём
υποθήκη — ипотека
τράπεζα — банк
μεσίτης — риэлтор
γραφείο ακινήτων — агентство недвижимости
πελάτης — клиент
επενδυτής — инвестор

# Οικονομία και επενδύσεις (Экономика и инвестиции)
επένδυση — инвестиция
κεφάλαιο — капитал
απόδοση — доходность / отдача
κέρδος — прибыль
ζημιά — убыток / ущерб
ρίσκο — риск
φορολογία — налогообложение
εισόδημα — доход
έξοδα — расходы
έσοδα — поступления / выручка
λογαριασμός — счёт
συμβουλή — совет / консультация
στρατηγική — стратегия
σχέδιο — план

# Ρήματα (Глаголы)
αγοράζω — покупаю
πουλάω — продаю
ενοικιάζω — сдаю / арендую
επενδύω — инвестирую
πληρώνω — плачу
υπογράφω — подписываю
συμφωνώ — соглашаюсь
διαπραγματεύομαι — веду переговоры / торгуюсь
κερδίζω — выигрываю / зарабатываю
χάνω — теряю / проигрываю
υπολογίζω — подсчитываю / рассчитываю
προγραμματίζω — планирую / программирую
