# Προσωπικές πληροφορίες (Личная информация)

όνομα — имя  
επίθετο — фамилия  
ηλικία — возраст  
χώρα — страна  
πόλη — город  
διεύθυνση — адрес  
τηλέφωνο — телефон  
κινητό — мобильный телефон  
email — электронная почта  

# Άτομα (Люди)
άνδρας — мужчина  
γυναίκα — женщина  
παιδί — ребёнок  
αγόρι — мальчик / парень  
κορίτσι — девочка / девушка  
φίλος — друг (муж.)  
φίλη — подруга (жен.)  
μαθητής — ученик  
μαθήτρια — ученица  
φοιτητής — студент  
φοιτήτρια — студентка  
δάσκαλος — учитель  
δασκάλα — учительница  
καθηγητής — преподаватель  
καθηγήτρια — преподавательница  
γιατρός — врач  
οδηγός — водитель  
πωλητής — продавец  
υπάλληλος — служащий / сотрудник  
σερβιτόρος — официант  
σερβιτόρα — официантка  
μάγειρας — повар  
εργάτης — рабочий  
μηχανικός — инженер  
δικηγόρος — юрист / адвокат  
καλλιτέχνης — художник / артист  
τραγουδιστής — певец  
αθλητής — спортсмен  

# Ρήματα (Глаголы)
σπουδάζω — учусь (в университете)  
δουλεύω — работаю  
μένω — живу / проживаю  
είμαι — я есть / являюсь  
έχω — имею / у меня есть  
έρχομαι — прихожу / приезжаю  
πηγαίνω — иду / хожу / еду  
γνωρίζω — знаю / знакомлюсь  
λέγομαι — меня зовут / называюсь  
κατάγομαι — происходить (из), родом (из)  
