### Παιδιά, σχολείο, παιδικός σταθμός (Дети, школа, детский сад)

# Παιδιά και οικογένεια (Дети и семья)
παιδί — ребёнок
μωρό — младенец / малыш
μαθητής — ученик
μαθήτρια — ученица
φίλος — друг (мальчик)
φίλη — подруга (девочка)
παιχνίδι — игрушка / игра
κούκλα — кукла
μπάλα — мяч
παζλ — пазл
παραμύθι — сказка
ζωγραφιά — рисунок
χαρά — радость
γέλιο — смех
κλάμα — плач

# Σχολείο (Школа)
σχολείο — школа
δημοτικό — начальная школа
νηπιαγωγείο — детский сад
παιδικός σταθμός — ясли / детский сад
τάξη — класс
δασκάλα — учительница
δάσκαλος — учитель
μαθητές — ученики
πίνακας — доска
βιβλίο — книга
τετράδιο — тетрадь
μολύβι — карандаш
στυλό — ручка
γόμα — ластик
μαρκαδόρος — фломастер
κασετίνα — пенал
σχολική τσάντα — школьный портфель
διάλειμμα — перемена
καμπανάκι — звонок
αυλή — двор / школьный двор
μάθημα — урок
ασκήσεις — упражнения
εργασία — работа / задание

# Ρήματα (Глаголы)
μαθαίνω — учусь / узнаю
διαβάζω — читаю / учусь
γράφω — пишу
μετράω — считаю
ζωγραφίζω — рисую
παίζω — играю
τραγουδώ — пою
χορεύω — танцую
τρέχω — бегаю
μιλάω — говорю
ακούω — слушаю / слышу
σηκώνω το χέρι — поднимаю руку
απαντώ — отвечаю
ρωτάω — спрашиваю
παίζω με φίλους — играю с друзьями

# Εκφράσεις (Фразы)
πάω σχολείο — иду в школу
κάνω μάθημα — занимаюсь / провожу урок
παίζω στο διάλειμμα — играю на перемене
γράφω στο τετράδιο — пишу в тетради
διαβάζω το βιβλίο μου — читаю свою книгу
