# Ταξίδια και διακοπές (Путешествия и отдых)

ταξίδι — путешествие
διακοπές — каникулы / отпуск
ξεκούραση — отдых
ξενοδοχείο — гостиница / отель
δωμάτιο — комната / номер
κράτηση — бронь / резервирование
βαλίτσα — чемодан
τσάντα — сумка
χάρτης — карта
εισιτήριο — билет
διαβατήριο — паспорт
ταυτότητα — удостоверение личности

παραλία — пляж
θάλασσα — море
βουνό — гора
λίμνη — озеро
ποτάμι — река

μουσείο — музей
μνημείο — памятник
αξιοθέατο — достопримечательность
εκδρομή — экскурсия / поездка

οδηγός — гид / водитель
τουρίστας — турист
τουρισμός — туризм

# Εκφράσεις και ρήματα (Выражения и глаголы)
πηγαίνω διακοπές — еду в отпуск
ταξιδεύω — путешествую
παίρνω ταξί — беру такси
παίρνω το λεωφορείο — сажусь в автобус
παίρνω το τρένο — сажусь в поезд
παίρνω το αεροπλάνο — лечу на самолёте
μένω σε ξενοδοχείο — живу в отеле
κάνω κράτηση — бронирую
κάνω μπάνιο στη θάλασσα — купаюсь в море
κάνω ηλιοθεραπεία — загораю
βγάζω φωτογραφίες — фотографирую
επισκέπτομαι — посещаю
περπατάω στην πόλη — гуляю по городу
