# Αγορές και ρούχα (Покупки и одежда)

κατάστημα — магазин
σούπερ μάρκετ — супермаркет
αγορά — рынок / покупка
μαγαζί — лавка / магазин
βιτρίνα — витрина
ταμείο — касса
καλάθι — корзина
σακούλα — пакет
προϊόν — продукт / товар
τιμή — цена
λεφτά — деньги
ευρώ — евро
κέρμα — монета
χαρτονόμισμα — банкнота

ακριβός — дорогой
φθηνός — дешёвый

αγοράζω — покупаю
πουλάω — продаю
πληρώνω — плачу
ζητάω — прошу / спрашиваю
παραγγέλνω — заказываю
δοκιμάζω — примеряю / пробую
παίρνω ρέστα — получаю сдачу

ρούχα — одежда
παπούτσια — обувь
παντελόνι — брюки
μπλούζα — блузка / кофта
πουκάμισο — рубашка
φούστα — юбка
φόρεμα — платье
σακάκι — пиджак
παλτό — пальто
μπότες — сапоги
παπούτσι — туфля / ботинок
κάλτσα — носок
καπέλο — шляпа / кепка
γάντι — перчатка
μαγιό — купальник
ζώνη — ремень
τσάντα — сумка
γυαλιά — очки

φορώ — ношу / надеваю
βγάζω — снимаю (одежду)
δοκιμάζω — примеряю
μου ταιριάζει — мне подходит / идёт
