# Αυτοβελτίωση (Саморазвитие)
αυτοβελτίωση – саморазвитие
στόχος – цель
επιτυχία – успех
αποτυχία – неудача
προσπάθεια – усилие
πειθαρχία – дисциплина
συνήθεια – привычка
παρακίνηση – мотивация
αυτοέλεγχος – самоконтроль
υπομονή – терпение
επιμονή – настойчивость
ενέργεια – энергия
χαλάρωση – расслабление
ισορροπία – баланс

# Διάβασμα και εκπαίδευση (Чтение и обучение)
βιβλίο – книга
περιοδικό – журнал
άρθρο – статья
γνώση – знание
εκπαίδευση – образование
μάθηση – обучение
σεμινάριο – семинар
μάθημα – урок
διαδίκτυο – интернет
πληροφορία – информация
παράγραφος – параграф
κεφάλαιο – глава
σημειώνω – я делаю заметки
διαβάζω – я читаю
γράφω – я пишу
μαθαίνω – я учусь

# Χρηματοοικονομική παιδεία (Финансовая грамотность)
χρήματα – деньги
εισόδημα – доход
έξοδα – расходы
προϋπολογισμός – бюджет
αποταμίευση – сбережение
επένδυση – инвестиция
κεφάλαιο – капитал
λογαριασμός – счёт
τράπεζα – банк
κάρτα – карта
μετρητά – наличные
κίνδυνος – риск
ασφάλεια – безопасность
οικονομία – экономика
φόρος – налог
δάνειο – заём
υποθήκη – ипотека

# Επενδύσεις (Инвестиции)
αγορά – покупка
πώληση – продажа
μετοχή – акция
ομόλογο – облигация
ακίνητο – недвижимость
χρυσός – золото
αγοράζω – я покупаю
πουλάω – я продаю
επενδύω – я инвестирую
κερδίζω – я зарабатываю
χάνω – я теряю
διαπραγματεύομαι – я веду переговоры
υπολογίζω – я рассчитываю
σχεδιάζω – я планирую
στρατηγική – стратегия
στόχος επένδυσης – инвестиционная цель
απόδοση – доходность
ρίσκο – риск
κερδοφορία – прибыльность
