### Ραντεβού (Свидание)

# Στο εστιατόριο (В ресторане)
εστιατόριο — ресторан
καφετέρια — кафетерий / кафе
μπαρ — бар
τραπέζι — стол
καρέκλα — стул
μενού — меню
ποτό — напиток
φαγητό — еда / блюдо
παραγγέλνω — заказываю
δοκιμάζω — пробую
μου αρέσει — мне нравится
δε μ’ αρέσει — мне не нравится
λογαριασμός — счёт
πληρώνω — плачу
κέρασμα — угощение

# Βόλτα και δραστηριότητες (Прогулка и занятия)
πάρκο — парк
παραλία — пляж
βόλτα — прогулка
συναυλία — концерт
κινηματογράφος — кинотеатр
θέατρο — театр
μουσική — музыка
χορός — танец
τραγούδι — песня
χορεύω — танцую
τραγουδώ — пою
παίζω μουσική — играю музыку
ακούω μουσική — слушаю музыку
γελάω — смеюсь
περνάω ωραία — хорошо провожу время

# Κομπλιμέντα (Комплименты)
είσαι όμορφη — ты красивая
είσαι πολύ γλυκιά — ты очень милая
σου πάει πολύ — тебе очень идёт
έχεις ωραία μάτια — у тебя красивые глаза
χαμογελάς όμορφα — ты красиво улыбаешься
είσαι καταπληκτική — ты потрясающая

# Συναισθήματα (Эмоции)
μου αρέσει η παρέα σου — мне нравится твоя компания
νιώθω χαρούμενος — я чувствую себя счастливым
νιώθω άνετα μαζί σου — я чувствую себя уютно с тобой
θέλω να σε ξαναδώ — я хочу снова тебя увидеть

# Ρήματα (Глаголы)
καλώ — приглашаю / зову
περνάω — провожу (время)
συναντώ — встречаю
γνωρίζω — знакомлюсь / знаю
ακούω — слушаю / слышу
γελάω — смеюсь
κοιτάζω — смотрю
νιώθω — чувствую
αγαπώ — люблю
φιλάω — целую
