### Σπίτι (Дом, 60 слов)

σπίτι — дом  
δωμάτιο — комната  
κουζίνα — кухня  
μπάνιο — ванная  
καθιστικό — гостиная  
υπνοδωμάτιο — спальня  

έπιπλα — мебель  
καρέκλα — стул  
τραπέζι — стол  
καναπές — диван  
κρεβάτι — кровать  
ντουλάπα — шкаф  

πόρτα — дверь  
παράθυρο — окно  
χαλί — ковёр  
λάμπα — лампа  
φωτιστικό — светильник  

τηλεόραση — телевизор  
ψυγείο — холодильник  
φούρνος — духовка  
πλυντήριο — стиральная машина  
νεροχύτης — раковина / мойка  
ντουλάπι — шкафчик  
κουρτίνα — занавеска / штора  
εικόνα — картина / изображение  
καθρέφτης — зеркало  
βιβλιοθήκη — книжный шкаф / библиотека  
ράφι — полка  

κουδούνι — звонок  
θυροτηλέφωνο — домофон  

καθαριότητα — уборка / чистота  
σκούπα — метла / пылесос  
σφουγγάρι — губка  
σαπούνι — мыло  
πετσέτα — полотенце  
μαξιλάρι — подушка  
κουβέρτα — одеяло  
πατάκι — коврик  
κάδος — ведро / мусорное ведро  

καφετιέρα — кофеварка  
ποτήρι — стакан  
πιάτο — тарелка  
μαχαιροπίρουνα — столовые приборы  
μπουκάλι — бутылка  
βάζο — ваза  
κάδρο — рамка (для картины / фото)  
λουλούδι — цветок  
φυτό — растение  

κουζίνα — кухня  
τραπεζαρία — столовая  
καθιστικό — гостиная  
τζάκι — камин  
μπαλκόνι — балкон  
πόρτα εισόδου — входная дверь  
σκάλες — лестница  
ασανσέρ — лифт  
κλειδί — ключ  
ρολόι — часы  
θερμοσίφωνας — бойлер  
καλοριφέρ — радиатор  
