### Φύση (Природа, 60 слов)

ήλιος — солнце  
φεγγάρι — луна  
αστέρι — звезда  
ουρανός — небо  
σύννεφο — облако  
βροχή — дождь  
χιόνι — снег  
άνεμος — ветер  
θάλασσα — море  
ποτάμι — река  
λίμνη — озеро  
βουνό — гора  
δάσος — лес  
δέντρο — дерево  
λουλούδι — цветок  
χορτάρι — трава  
φυτό — растение  
ζώο — животное  
πουλί — птица  
ψάρι — рыба  
έντομα — насекомые  
πεταλούδα — бабочка  
μέλισσα — пчела  
σκύλος — собака  
γάτα — кошка  
άλογο — лошадь  
αγελάδα — корова  
πρόβατο — овца  
χοίρος — свинья  
ελάφι — олень  
αρκούδα — медведь  
λιοντάρι — лев  
τίγρη — тигр  
ερπετό — пресмыкающееся / рептилия  
φίδι — змея  
βατράχι — лягушка  
σαλιγκάρι — улитка  
αράχνη — паук  
μυρμήγκι — муравей  
θάμνος — куст / кустарник  
ρίζα — корень  
βολβός — луковица  
καρπός — плод  
φρούτο — фрукт  
σπόρος — семя  
φύλλο — лист  
κλαδί — ветка  
κορμός — ствол  
βράχος — скала  
σπήλαιο — пещера  
παγετώνας — ледник  
ηφαίστειο — вулкан  
θύελλα — буря  
καταιγίδα — гроза / шторм  
ουράνιο τόξο — радуга  
πέτρα — камень  
άμμος — песок  
παραλία — пляж  
κύμα — волна  
λιμνοθάλασσα — лагуна  
