### Ταξίδια (Путешествия, 60 слов)

αεροδρόμιο — аэропорт
αεροπλάνο — самолёт
ταξί — такси
τρένο — поезд
λεωφορείο — автобус
αυτοκίνητο — автомобиль
ποδήλατο — велосипед
βαλίτσα — чемодан
διαβατήριο — паспорт
χάρτης — карта
ξενοδοχείο — гостиница / отель
δωμάτιο — комната / номер
κράτηση — бронь / резервирование
οδηγός — водитель / гид
τουρίστας — турист
εκδρομή — экскурсия / поездка
παραλία — пляж
βουνό — гора
πόλη — город
χωριό — деревня
μουσείο — музей
αξιοθέατο — достопримечательность
λιμάνι — порт
πλοίο — корабль / судно
στάση — остановка
εισιτήριο — билет
γραμμή — линия / маршрут
αφετηρία — отправная точка
προορισμός — пункт назначения
ταξίδι — путешествие
περιπέτεια — приключение
διαμονή — проживание / размещение
τοπία — пейзажи / ландшафты
μνημείο — памятник
περίπατος — прогулка
βόλτα — прогулка / поездка
δρομολόγιο — расписание / маршрут
στάδιο — стадион
πάρκινγκ — парковка
αεροπορική εταιρεία — авиакомпания
εισιτήρια — билеты
τουρισμός — туризм
ταξιδιώτης — путешественник
παρατηρητήριο — смотровая площадка / обсерватория
ενοικίαση — аренда
ξεναγός — экскурсовод / гид
ποδηλασία — езда на велосипеде
πεζοπορία — пеший поход / хайкинг
περιήγηση — экскурсия / тур
σακίδιο — рюкзак
κάμπινγκ — кемпинг
βάρκα — лодка
