### Εργασία (Работа, 60 слов)

εργασία — работа / задание  
δουλειά — работа / труд  
γραφείο — офис  
αφεντικό — начальник / босс  
συνάδελφος — коллега  
υπάλληλος — сотрудник / служащий  
πελάτης — клиент  
συνάντηση — встреча / собрание  
ραντεβού — встреча / приём  
τηλεφωνητής — оператор / телефонист  

υπολογιστής — компьютер  
έγγραφο — документ  
φάκελος — папка / досье  
αναφορά — отчёт  
σύμβαση — контракт / договор  
παρουσίαση — презентация  
προθεσμία — срок / дедлайн  
έργο — проект / дело  
εργοδότης — работодатель  
εργαζόμενος — работник / сотрудник  

τμήμα — отдел  
διαχείριση — управление / менеджмент  
μισθός — зарплата  
σύμβουλος — консультант / советник  
διευθυντής — директор / управляющий  
υπεύθυνος — ответственный  
καθήκον — обязанность  
υπογραφή — подпись  
αίτηση — заявление / заявка  
βιογραφικό — резюме  

συνέντευξη — интервью / собеседование  
προαγωγή — повышение  
πρότζεκτ — проект  
εργασία από το σπίτι — работа из дома / удалённая работа  
συσκευή — устройство  
πρόγραμμα — программа  
πελατολόγιο — клиентская база  
παραγγελία — заказ  
εκπαίδευση — обучение  
σεμινάριο — семинар  

σύστημα — система  
προγραμματισμός — программирование / планирование  
λογισμικό — программное обеспечение  
αναλυτής — аналитик  
γραμματέας — секретарь  
διαχείριση χρόνου — тайм-менеджмент  
σχέδιο — план  
ανασκόπηση — обзор / ревью  
προϋπολογισμός — бюджет  
επαγγελματικό — профессиональное  

εκτίμηση — оценка  
εργασία ομάδας — командная работа  
διαπραγμάτευση — переговоры  
παραγωγικότητα — производительность  
στόχος — цель  
επίτευγμα — достижение  
